DWOOOOOOOWWWOOO
OWWOOOOWOWOOOOO
OOWWOOWWOWOWWOW
OOOWWWWOOWOWOOO
OOOOWOOOWWOWWWO
OOOOOOOWWWOWOOO
WWWWWWOOOOOWOOW
OOWOOWOWOWOWOOO
OOWOOWOWWWOWOWO
OOOOOWOWOWOOOWW
WWWWOOOOOOOOWWW
OWOOOWWWOOWOOOO
OWWWOWOWWOWWOWW
OOOWOWOOOOOWOGS
OWOOOWOOWOOWWWW